x------------------------------------------------x
x--------------------------------c---------------x
x--------------------------------c---------------x
x--------------------------------x---------------x
x---------------c----------------x---------------x
x---------------c----------------x---------------x
x---------------c----------------x---------------x
x---------------x----p-----------x---------------x
x--------------xx-------------z--xx--------------x
x-------------xxx----------------xxx-------------x
x------------xxxx----------------xxxx------------x
x------c----xxxxx----------------xxxxx---c-------x
xxxxxxxxxxxxxxxxxxxxxxxxxxxxxxxxxxxxxxxxxxxxxxxxxx