x------------------------------------------------x
x--------------------------------c---------------x
x--------------------------------c---------------x
x--------------------------------x---------------x
x---------------c----------------x---------------x
x---------------c----------------x---------------x
x---------------c----------------x---------------x
x---------------x----------------x---------------x
x--------------xx-------------z--xx--------------x
x-------------xxx-------xx--------xx-------------x
x------------xx----p--xxxxxxx-----xxx------------x
x------c----xxxxx----x-----------xxxxx---c-------x
xxxxxxxxxxxxxxxxxxxxxxxxxxxxxxxxxxxxxxxxxxxxxxxxxx