x------------------------------------------------x
x--------------------------------c---------------x
x--------------------------------c---------------x
x--------------------------------x---------------x
x---------------c----------------x---------------x
x---------------c----------------x---------------x
x---------------c----------------x---------------x
x---------------x----------------x---------------x
x--------------xx-------------z--xx--------------x
x-------------xxx-----------------xx-------------x
x------------xx----p--------------xxx------------x
x------c----xxxxx----------------xxxxx---c-------x
xxxxxxxxxxxxxxxxxxxxxxxxxxxxxxxxxxxxxxxxxxxxxxxxxx