x-----------------------------x
x-----------------------------x
x----------------------c------x
x-----c----------------c------x
x-----c----------------c------x
x-----c----------------x------x
x-----c--------c-------x------x
x-----x--------c-------x------x
x----xx-------ccc------xx-----x
x---xxx-------xxxx------xx----x
x--xx---p---xxxxxxx--z--xxx---x
x-c-xxxxx----xxxxx---x-xxxxx--x
xxxxxxxxxxxxxxxxxxxxxxxxxxxxxxx